This file is meant to help you know which id corresponds to which moves.
While not perfect, this should be useful in figuring out how to replace the sounds you want.
Sound FX id is on the left, moves that use it are on the right.

100slaps: nair getupatk 
airdodge: airdodge p_ad_land 
bite: spf2 
bow: spu 
bowfire: spu 
cards: tauntvask strair_cards 
charge: spd 
chip: spn spn_sa 
coolercrash: dthrow 
coolerdrop: dthrow 
cough: grabpummel 
crossbowfire: fthrow 
crossbowload: fthrow 
crouch: crouch 
dashjump: spf 
drill: dair 
edge: grabedge 
entrance: entrance 
fastfall: p_checkspecialfastfall 
firetrail: spn_sa 
footstep: walk tapdash turn crouch_fwd crouch_back 
grabbed: grabbed 
grabwhiff: grab 
headbutt: utilt 
helicopter: uair 
holler: dietop 
jump: jump0 jump1 shjump walljump 
ko: dieright dieleft diebottom diegrabbed diebox dieenemy 
land: down shieldbreakstand landeasy landlag landlag_lc landlag_lc_2 landlag_special landlag_ad 
lcancel: tapdash landlag_lc landlag_lc_2 
losemoney: hitlag grabbed tauntvask 
mediumhit: uthrow dthrow nair getupatk fair ftilt bair spf2 utilt climbedgeatk spu 
mediumsword: uair dair 
mediumwhiff: climbedgeatk 
motion: fair ustr 
motionalt: jab dtilt 
plank: climbedgeatk 
pop: entrance 
popsmall: crouchend 
roll: dodgestill 
shieldbreak: shieldbreak 
shieldoff: shieldout dodgestill shieldout_v1 dodgefwd dodgeback 
shieldon: shield shield_v1 
slam: uthrow 
slide: getupfwd getupback techrollfwd techrollback dodgefwd climbup dodgeback edgeroll 
smallhit: jab nair spn spn_sa dtilt dstr1 
smallsword: uair dair 
smashhit: fstr1 ustr1 
sneakstep: walk 
spin: bair 
splat: fstr1 
squeak: spd 
starko: dietop 
straircharge: strair 
stronghit: strair1 
strongwhiff: fair fstr1 ftilt ustr1 dstr1 strair1 
talk: tauntanim crouchtaunt 
tech: techland techrollfwd techrollback techwall techceiling airtech 
throw: bthrow 
whip: tauntanim 
